10 15
0 0
0 0 0 0 0 0 0 0 0 0
0 0 9 0 0 0 0 0 0 0
0 0 0 0 0 0 0 0 0 0
0 0 0 0 7 7 0 0 11 0
0 0 0 7 7 7 7 0 0 0
0 0 7 7 7 7 7 7 0 0
0 0 7 7 7 7 7 7 0 0
0 0 0 7 7 7 7 0 0 0
0 0 0 0 7 7 8 0 0 0
0 11 0 0 12 0 0 0 0 0
0 0 0 0 0 12 0 0 0 0
0 0 0 0 12 0 0 0 0 0
0 0 0 0 12 0 0 0 0 0
0 0 0 10 0 12 10 0 0 0
0 0 0 0 6 6 0 0 0 0
