10 15
0 0
0 0 11 0 4 3 0 0 0 0
0 0 0 0 2 1 0 0 9 0
0 0 0 10 12 12 10 0 0 0
0 0 0 0 12 12 0 0 0 0
0 13 0 0 12 12 0 0 0 0
0 0 0 0 12 12 0 0 0 0
0 0 0 0 12 12 0 9 0 0
0 11 0 0 12 12 0 0 0 0
0 0 0 9 12 12 0 0 13 0
0 0 0 0 12 12 0 0 0 0
0 0 0 0 12 12 0 0 9 0
0 0 0 0 12 12 0 0 0 0
0 0 0 0 12 12 0 0 0 0
0 9 0 0 12 12 0 0 0 0
0 0 0 0 0 0 0 0 0 0 0
